
PES 2017 -
All Tvvins - Thank You - ok*****
Clean - Big Data - ok*****
Ellie Goulding - On My Mind - ok*****
In my Head - Galantis - ok*****
Hunter Hunted - Keep Together - ok*****
JR JR - "In The Middle" - ok*****
Miike Snow - Genghis Khan - ok***** 
Peking Duk ft. Nicole Millar - "High" - ok*****

PES 2016 -
Vinyl Theatre: Shine On - ok*****
Madeon - You're On ft. Kyan  - ok*****
Clean Bandit - Rather Be ft. Jess Glynne  - ok*****
Broken Bells - After the Disco - ok*****
St. Lucia - Elevate
Dillon Francis + Sultan & Ned Shepard - When We Were Young ft. The Chain Gang of 1974
Passion Pit - Lifted Up (1985)
SAINT MOTEL - My Type
Joywave - Somebody New
Royal Blood - Figure It Out
Queen - We Will Rock You


PES 2015 -
American Authors - Best Day of My Life
Avicii ft. aloe blacc - wake me up
bastille - pompeii
Bombay bicycle club - luna
calvin harris ft. ellie goulding - i need your love
cold war kids - miracle mile
imagine dragons - demons
morining parade - shake the cage
the preatures - is this how do you feel
wilkinson - afterglow


PES 2014 -
Guajira Guantanamera


PES 2013 -

Teeth - SeeSpaces
Oberhofer - Gold
Imagine Dragons - On Top of The World
Savoir Adore - Dreamers
Rednek - They Call Me (Radio Mix)


PES 2012 -
Cold Cave - Life Magazine
Sub Focus - Rock It
The Chemical Brothers - Swoon

